4 2 2 2 2 20 2 2 2 2 2 2 2 2 2 6
3 0 0 0 0 20 0 0 0 0 1 1 1 1 1 5
3 0 0 0 0 20 0 0 0 0 0 1 1 1 1 5
3 0 0 0 0 25 21 21 21 22 0 0 1 1 0 5
3 0 0 0 0 0 0 0 0 20 0 0 0 0 0 5
3 0 1 0 0 0 0 0 0 25 21 21 22 0 0 5
3 1 1 1 0 14 15 0 0 0 0 0 20 0 0 5
3 1 1 1 14 16 17 13 15 0 0 0 20 0 0 5
3 1 1 14 16 7 12 8 10 0 0 0 20 0 0 5
3 0 1 9 8 8 10 0 0 0 24 21 23 0 0 5
3 0 0 0 0 0 0 0 0 0 20 0 0 0 0 5
2 2 2 2 2 2 2 2 2 2 20 2 2 2 2 2