4  2  2  2  2  2  2  2  2  2  2  2  2  2  2  2  2  2  2  2  2  2  2  2  2  2  2  2  2  2  2  2  2  2  2  2  2  2  2  2  2  2  2  2  2  2  2  2  2  6
3  1  1  1  1  1  1  1  1  1  1  1  1  1  1  1  1  1  1  1  1  1  1  1  1  1  1  1  1  1  1  1  1  1  1  1  1  1  1  1  1  1  1  1  1  1  1  1  1  5
3  1  1  1  1  1  1  1  1  1  1  1  1  1  1  1  1  1  1  1  1  1  1  1  1  1  1  1  1  1  1  1  1  1  1  1  1  1  1  1  1  1  1  1  1  1  1  1  1  5
3  1  1  1  1  1  1  1  1  1  1  1  1  1  1  1  1  1  1  1  1  1  1  1  1  1  1  1  1  1  1  1  1  1  1  1  1  1  1  1  1  1  1  1  1  1  1  1  1  5
3  1  1  1  1  1  1  1  1  1  1  1  1  1  1  1  1  1  1  1  1  1  1  1  1  1  1  1  1  1  1  1  1  1  1  1  1  1  1  1  1  1  1  1  1  1  1  1  1  5
3  1  1  1  1  1  1  1  1  1  1  1  1  1  1  1  1  1  1  1  1  1  1  1  1  1  1  1  1  1  1  1  1  1  1  1  1  1  1  1  1  1  1  1  1  1  1  1  1  5
3  1  1  1  1  1  1  1  1  1  1  1  1  1  1  1  1  1  1  1  1  1  1  1  1  1  1  1  1  1  1  1  1  1  1  1  1  1  1  1  1  1  1  1  1  1  1  1  1  5
3  1  1  1  1  1  1  1  1  1  1  1  1  1  1  1  1  1  1  1  1  1  1  1  1  1  1  1  1  1  1  1  1  1  1  1  1  1  1  1  1  1  1  1  1  1  1  1  1  5
3  1  1  1  1  1  1  1  1  1  1  1  1  1  1  1  1  1  1  1  1  1  1  1  1  1  1  1  1  1  1  1  1  1  1  1  1  1  1  1  1  1  1  1  4  2  2  2  6  5
3  1  1  1  1  1  1  1  1  1  1  1  1  1  1  1  1  1  1  1  1  1  1  1  1  1  1  1  1  1  1  1  1  1  1  1  1  1  1  1  1  1  1  1  36  35  35  35  37  5
3  1  1  1  1  1  1  1  1  1  1  1  1  1  1  1  1  1  1  1  1  1  1  1  1  1  1  1  1  1  1  1  1  1  1  1  1  1  1  1  1  1  1  1  36  35  35  35  37  5
3  1  1  1  1  1  1  1  1  1  1  1  1  1  1  1  1  1  1  1  1  1  1  1  1  1  1  1  1  1  1  1  1  1  1  1  1  1  1  1  1  1  1  1  36  35  35  35  37  5
3  1  1  1  1  1  1  1  1  1  1  1  1  1  1  1  1  1  1  1  1  1  1  1  1  1  1  1  1  1  1  1  1  1  1  1  1  1  1  1  1  1  1  1  36  35  35  35  37  5
3  1  1  1  1  1  1  1  1  1  1  1  1  1  1  1  1  1  1  1  1  1  1  1  1  1  1  1  1  1  1  1  1  1  1  1  1  1  1  4  2  2  2  2  2  2  35  2  6  5
3  1  1  1  1  1  1  1  1  1  1  1  1  1  1  1  1  1  1  1  1  1  1  1  1  1  1  1  1  1  1  1  1  1  1  1  1  1  1  36  35  35  35  35  35  35  35  35  37  5
3  1  1  1  1  1  1  1  1  1  1  1  1  1  1  1  1  1  1  1  1  1  1  1  1  20  1  1  1  1  1  1  1  1  1  1  1  1  1  36  35  35  35  35  35  35  35  35  37  5
3  1  1  1  1  1  1  1  1  1  1  1  1  1  1  1  1  1  1  1  1  1  1  1  1  20  1  1  1  1  1  1  1  1  1  1  1  1  1  36  35  35  35  35  35  35  35  35  37  5
3  1  1  1  1  1  1  1  1  1  1  1  1  1  1  1  1  1  1  1  1  1  1  1  1  20  1  1  1  1  1  1  1  1  1  1  1  1  1  36  35  35  35  35  35  35  35  35  37  5
3  1  1  1  1  1  1  1  1  1  1  1  1  1  1  1  1  1  1  1  1  1  1  1  1  20  1  1  1  1  1  1  1  1  1  1  1  1  1  36  35  35  35  35  35  35  35  35  37  5
3  1  1  1  1  1  1  1  1  1  1  1  1  1  1  1  1  1  1  1  1  1  1  1  1  20  1  1  1  1  1  1  1  1  1  1  1  1  1  2  2  4  2  35  2  2  2  2  6  5
3  1  1  1  1  1  1  1  1  1  1  1  1  1  1  1  1  1  1  1  1  1  1  1  1  20  1  1  1  1  1  1  1  1  1  1  1  1  1  1  1  36  35  35  35  35  35  35  37  5
3  1  1  1  1  1  1  1  1  1  1  1  1  1  1  1  1  1  1  1  1  1  1  1  1  20  1  1  1  1  1  1  1  1  1  1  1  1  1  1  1  36  35  35  35  35  35  35  37  5
3  1  1  1  1  1  1  1  1  1  1  1  1  1  1  1  1  1  1  1  1  1  1  1  1  20  1  1  1  1  1  1  1  1  1  1  1  1  1  1  1  36  35  35  35  35  35  35  37  5
3  1  1  1  1  1  1  1  1  1  1  1  1  1  1  1  1  1  1  1  1  1  1  1  0  20  0  1  1  0  1  1  1  1  1  1  1  1  14  13  15  36  35  35  35  35  35  35  37  5
3  1  1  1  1  1  1  1  1  1  1  1  1  1  1  1  1  1  1  1  1  1  1  0  0  20  0  0  1  1  1  1  1  1  1  1  1  14  16  7  19  36  35  35  35  35  35  35  37  5
3  1  1  1  1  1  1  1  1  1  1  1  1  1  1  1  1  1  1  1  0  29  21  21  21  26  21  21  21  21  21  21  21  21  22  1  1  9  8  8  10  36  35  35  37  2  2  35  2  5
3  1  1  1  1  1  1  1  1  1  1  1  1  1  1  1  1  1  1  1  1  1  1  0  0  20  0  0  1  1  1  1  1  1  20  1  1  1  1  1  1  36  35  35  37  1  1  30  1  5
3  1  1  1  1  1  1  1  1  1  1  1  1  1  1  1  1  1  1  1  1  1  1  1  0  20  0  1  1  1  0  1  1  1  20  1  1  1  1  1  1  2  2  2  2  1  1  20  1  5
3  1  1  1  1  1  1  1  1  1  1  1  1  1  1  1  1  1  1  1  1  1  1  1  1  20  1  1  1  1  1  1  1  1  20  1  1  1  1  1  1  1  1  1  1  1  1  20  1  5
3  1  1  1  1  1  1  1  1  1  1  1  1  1  1  1  1  1  1  1  1  1  1  1  1  20  1  1  1  1  1  1  1  1  25  21  21  21  21  21  21  21  21  21  21  21  21  23  1  5
3  1  1  1  1  1  1  1  1  1  1  1  1  1  1  1  1  1  1  1  1  1  1  1  1  20  1  1  1  1  1  1  1  1  1  1  1  1  1  1  1  1  1  1  1  1  1  1  1  5
3  1  1  1  1  1  1  1  1  1  1  1  1  1  1  1  1  1  1  1  1  1  1  1  1  20  1  1  0  0  1  1  1  1  1  1  1  1  1  1  1  1  1  1  1  1  1  1  1  5
3  1  1  1  1  1  1  1  1  1  1  1  1  1  1  1  1  1  1  1  1  0  1  1  1  20  1  1  0  1  1  1  1  1  1  1  1  1  1  1  1  1  1  1  1  1  1  1  1  5
3  1  1  1  1  1  1  1  1  1  1  1  1  1  1  1  1  1  0  1  1  1  1  1  1  20  1  1  1  1  1  1  1  1  1  1  1  1  1  1  1  1  1  1  1  1  1  1  1  5
3  1  1  1  1  1  1  1  1  1  1  1  1  1  1  1  1  1  1  1  1  24  21  21  21  23  1  1  1  1  1  1  1  1  1  1  1  1  1  1  1  1  1  1  1  1  1  1  1  5
3  1  20  1  1  1  0  1  1  0  0  1  1  1  1  0  0  1  24  21  21  23  14  13  13  13  13  13  13  13  13  13  13  15  1  1  1  1  1  1  1  1  1  1  1  1  1  1  1  5
3  1  20  1  1  1  1  1  1  1  1  1  1  1  1  1  1  1  20  14  13  13  16  7  7  7  7  7  7  7  7  7  7  17  15  1  1  1  1  1  1  1  1  1  1  1  1  1  1  5
3  1  20  0  1  1  1  1  1  1  1  1  1  1  1  1  1  0  20  18  7  7  7  7  7  7  7  7  7  7  7  7  7  7  17  13  15  1  1  1  1  1  1  1  1  1  1  1  1  5
3  1  44  21  21  21  21  21  21  21  45  21  21  21  21  21  21  21  23  18  7  7  7  7  7  7  7  7  7  7  7  7  7  7  7  7  19  1  1  1  1  1  1  1  1  1  1  1  1  5
3  1  20  0  1  1  1  1  1  0  20  0  1  1  1  1  1  1  1  18  7  7  7  7  7  7  7  7  7  7  7  7  7  7  7  7  19  1  1  1  1  1  1  1  1  1  1  1  1  5
3  1  20  1  1  1  1  1  1  1  20  1  0  1  0  1  14  13  13  16  7  7  7  7  7  7  7  7  7  7  7  7  7  12  8  8  10  1  1  1  1  1  1  1  1  1  1  1  1  5
3  1  20  1  1  1  1  1  1  1  20  1  1  1  0  1  18  7  7  7  7  7  7  7  7  7  7  7  7  7  7  7  7  19  1  1  1  1  1  1  1  1  1  1  1  1  1  1  1  5
3  1  27  1  1  1  0  1  1  0  20  1  1  1  1  1  18  7  7  7  7  7  7  7  7  7  7  7  7  7  7  7  7  19  1  1  1  1  1  1  1  1  1  1  1  1  1  1  1  5
3  1  0  1  1  1  0  1  1  1  20  1  1  1  1  1  9  8  8  8  11  7  7  7  7  7  7  7  7  7  7  12  8  10  1  1  1  1  1  1  1  1  1  1  1  1  1  1  1  5
3  1  0  0  0  1  1  1  1  1  20  1  1  1  1  1  4  2  2  6  18  7  7  7  7  7  7  7  7  7  7  19  1  1  1  1  1  1  1  1  1  1  1  1  1  1  1  1  1  5
3  1  14  15  0  0  1  1  1  1  20  1  0  1  1  1  36  35  35  37  18  7  7  7  7  12  8  8  8  8  8  10  1  1  1  1  1  1  1  1  1  1  1  1  1  1  1  1  1  5
3  1  18  17  15  0  1  1  0  1  20  1  1  1  1  1  36  35  35  37  18  7  7  7  12  10  0  0  0  0  0  1  1  1  1  1  1  1  1  1  1  1  1  1  1  1  1  1  1  5
3  1  9  8  10  1  1  1  1  1  20  1  1  1  1  1  2  35  2  2  9  8  8  8  10  0  0  0  0  0  0  0  0  1  1  1  1  1  1  1  1  1  1  1  1  1  1  1  1  5
3  1  1  1  1  1  1  1  1  1  25  21  21  21  21  21  21  21  21  21  21  21  21  21  28  0  0  0  0  1  1  1  1  1  1  1  1  1  1  1  1  1  1  1  1  1  1  1  1  5
2  2  2  2  2  2  2  2  2  2  2  2  2  2  2  2  2  2  2  2  2  2  2  2  2  2  2  2  2  2  2  2  2  2  2  2  2  2  2  2  2  2  2  2  2  2  2  2  2  2